TTTTTTTTTTTTTTTTTTTTTTTTTTTTTTTTTTTTTTTTTTTTTTTTTTTTTTTTTTTTTTTTTTTTTTTTTTTTTTTTTTTTTTTTTTTTTTTTTTTTTTTTTTTTTTTTTTTTTTTTTTTTTTTTTTTTTTTTTTTTTTTTTTTTTTTTTTTTTTTTTTTTTTTTTTTTT
                                                                                                                                                                             
T  T  T  T  T  T  T  T  T  T  T  T  T  T  T  T  T  T  T  T  T  T  T  T  T  T  T  T  T  T  T  T  T  T  T  T  T  T  T  T  T  T  T  T  T  T  T  T  T  T  T  T  T  T  T  T  T  T
                                                                                                                                                                             
TTTTTTTTTTTTTTTTTTTTTTTTTTTTTTTTTTTTTTTTTTx   S   yTTTTTTTTTTTTTTTTTTTTTTTTx   S   yTTTTTTTTTTTTTTTTTTTx   S   yTTTTTTTTTTTTTTTTTTTTx   S   yTTTTTTTTTTTTTTTTTTTTTTTTTTTTTTTT
                                         yb   b   b                       yb   b   b                  yb   b   b                   yb   b   b
                                         Eb   b   b                       Eb   b   b                  Eb   b   b                   Eb   b   b
TTTTTTTTTTTTTTTTTTTTTTTTTx        yTTTTTTTvTTTTTTTvTTTTTTTTTTTTTTTTTTTTTTTTvTTTTTTTvTTTTTTTTTTTTTTTTTTTvTTTTTTTvTTTTTTTTTTTTTTTTTTTTvTTTTTTTvTTTTTTTx   yTTTTTTTTTTTTTTTTTTTT
                         b        b       b       b                        b       b                   b       b                    b       b       b   b
T T T T T T T T T T T    b        b       zTTTTTTTw                        zTTTTTTTw                   zTTTTTTTw                    zTTTTTTTw       b   b
                     b   b        b                               ___    __________  ____  ____  ____  ____  ______                                 b   b
TTTTTTTTTTTTTTTTTx       b        b                              /   |  / ____/ __ \/ __ \/ __ \/ __ \/ __ \/_  __/                                 b   b
TTTTTTTTTTTTTTTx b   b   b        b                             / /| | / __/ / /_/ / / / / /_/ / / / / /_/ / / /                                    b   b
               b b       b        b                            / ___ |/ /___/ _, _/ /_/ / ____/ /_/ / _, _/ / /                                     b   b
T T T T T T    b b   b   b        b                           /_/  |_/_____/_/ |_|\____/_/    \____/_/ |_| /_/                                      b   b
           b   b b       b        b                                                                                                                 b   b
TTTTTTTx       b b   b   b        zTTTTTTTTTTTTTSTTTTTTTSTTTTTTTTTTTTTTTTTTTTTTTTTTTTTTTTTTTTTTTTTTTTTTTTTTTTTTTTTTTTTTTTTTTTTTTTTTTTTTTTTTTSTTTTTTTF   zTTTTTTTTTTTTTTTTTTTT
       b   b   b b       b  yTTTTTTTTTTTTTTTTTTTF       b                                                                                   b       fTTTTTTTTTTTTTTTTTTTx    
       b       b b   b   b  b          M        b       b     yTTTTTTTTTTTTTTTTTTTTTTTTTTTTTTTTTTTTTTTTTTTTTTTTTTTTTTTTTTTTTTTTTTTTTTTx     b       b        M          b    
       b   b   b b       b  b    yTTTTTTTTTTTTTTF       b     b                                                                       b     b       fTTTTTTTTTTTTTTx    b    
       b       b b   b   b  b    b  yTTTTTTTTTTTjTTTTTTTw                                                                                   zTTTTTTTjTTTTTTTTTTx   b    b    
       b   b   b b       b  b    b  b              <TTT                                                                                        <TTT            b   b    b    
       b       b b   b   b  b    b  b                                                                                                                          b   b    b    
       b   b   b b       b  b    b  b    T T T T T T T T T T T T T TT T T T T T T T T T T T T T T T T T T T T T T T T T T T T T T T T T T T T T T T T T T T    b   b    b    
       b       b b   b   b  b    b  b   b                                                                                                                  b   b   b    b    
       b   b   b b       b  b    b  b              TTT>                                                                                        TTT>            b   b    b    
       b       b b   b   b  b    b  b   b   yTTTTTTTTTTTTTTTTTTTTTTTTTTTTTTTTTTTTTTTTTTTTTTTTTTTTTTTTTTTTTTTTTTTTTTTTTTTTTTTTTTTTTTTTTTTTTTTTTTTTTTTTTTx   b   b   b    b    
       b   b   b b       b  b    b  b       b                                                                                                          b       b   b    b    
       b       b b   b   b  b    b  b   b   b                                                                                                          b   b   b   b    b    
       b   b   b b       b  b MM b  b       b         yTTTTSTTTTSTTTTSTTTTSTTTTSTTTTSTTTTSTTTx                       yTTTTSTTTTSTTTTSTTTTSTTTx         b       b   b MM b   
       b       b b   b   b  b    b  b   b   b         b    b    b    b    b    b    b    b   b                       b    b    b    b    b   b         b   b   b   b    b    
       b   b   b b       b  b    b  b       zTTTTTTTTTw                                      zTTTTTTTTTTTTTTTTTTTTTTTw                       zTTTTTTTTTw       b   b    b    
       b       b b   b   b  b    b  b   b    <TTT                                                                                                <TTT      b   b   b    b    
       b   b   b b       b  b    b  b                                                                                                                          b   b    b    
       b       b b   b   b  b    b  b   b     T T T T T T T T T T T T T T T T T T T T T T TT T T T T T T T T T T T T T T T T T T T T T T T T T T T T T     b   b   b    b    
       b   b   b b       b  b    b  b         T T T T T T T T T T T T T T T T T T T T T  T T T T T T T T T T T T T T T T T T T T T T T T T T T T T T T         b   b    b    
       b       b b   b   b  b    b  b   b                                                                                                                  b   b   b    b    
       b   b   b b       b  b    b  b        TTT>                                                                                                TTT>          b   b    b    
       b       b b   b   b  b    b  b   b   yTTTTTTTTTTx                                     yTTTTTTTTTTTTTTTTTTTTTTTx                       yTTTTTTTTTx   b   b   b    b    
       b   b   b b       b  b    b  b       b          b    b    b    b    b   b    b    b   b                       b    b    b    b    b   b         b       b   b    b    
       b       b b   b   b  b    b  b   b   b          zTTTTjTTTTjTTTTjTTTTjTTTjTTTTjTTTTjTTTw                       zTTTTjTTTTjTTTTjTTTTjTTTw         b   b   b   b    b    
       b   b   b b       b  b    b  b       b                                                                                                          b       b   b    b    
       b       b b   b   b  b    b  b   b   b                                                                                                          b   b   b   b    b    