TTTTTTTTTTTTTTTTTTTTTTTTTTTTTTTTTTTTTTTTTTTTTTTTTTTTTTTTTTTTTTTTTTTTTTTTTTTTTTTTTTTTTTTTTTTTTTTTTTTTTTTTTTTTTTTTTTTTTTTTTTTTTTTTTTTTTTTTTTTTTTTTTTTTTTTTTTTTTTTTTTTTTTTTTTTTT
                                                                                                                                                                             
T  T  T  T  T  T  T  T  T  T  T  T  T  T  T  T  T  T  T  T  T  T  T  T  T  T  T  T  T  T  T  T  T  T  T  T  T  T  T  T  T  T  T  T  T  T  T  T  T  T  T  T  T  T  T  T  T  T
                                                                                                                                                                             
TTTTTTTTTTTTTTTTTTTTTTTTTTTTTTTTTTTTTTTTTTx   S   yTTTTTTTTTTTTTTTTTTTTTTTTx   S   yTTTTTTTTTTTTTTTTTTTx   S   yTTTTTTTTTTTTTTTTTTTTx   S   yTTTTTTTTTTTTTTTTTTTTTTTTTTTTTTTT
                            m m          yb   b   b                       yb   b   b                  yb   b   b                   yb   b   b                      m m
                            m m          Eb   b   b                       Eb   b   b                  Eb   b   b                   Eb   b   b                      m m
TTTTTTTTTTTTTTTTTTTTTTTTTx  m m   yTTTTTTTvTTTTTTTvTTTTTTTTTTTTTTTTTTTTTTTTvTTTTTTTvTTTTTTTTTTTTTTTTTTTvTTTTTTTvTTTTTTTTTTTTTTTTTTTTvTTTTTTTvTTTTTTTx              m m     
                         b  m m   b       b       b                        b       b                   b       b                    b       b       b              m m    
                         b  m m   b       zTTTTTTTw                        zTTTTTTTw                   zTTTTTTTw                    zTTTTTTTw       b              m m
                         b  m m   b                               ___    __________  ____  ____  ____  ____  ______                                 b              m m
TTTTTTTTTTTTTTTTTx       b  m m▒ ▒b                              /   |  / ____/ __ \/ __ \/ __ \/ __ \/ __ \/_  __/                                 b ▒ ▒ ▒ ▒ ▒ ▒ ▒m m
TTTTTTTTTTTTTTTx b       b  m m▒ ▒b                             / /| | / __/ / /_/ / / / / /_/ / / / / /_/ / / /                                    b ▒ ▒ ▒ ▒ ▒ ▒ ▒m m
               b b       b  m m▒ ▒b                            / ___ |/ /___/ _, _/ /_/ / ____/ /_/ / _, _/ / /                                     b ▒ ▒ ▒ ▒ ▒ ▒ ▒m m
               b b       b  m m   b                           /_/  |_/_____/_/ |_|\____/_/    \____/_/ |_| /_/                                      b              m m
               b b       b  m m   b                                                                                                                 b              m m    
TTTTTTTx       b b       b  m m   zTTTTTTTTTTTTTSTTTTTTTSTTTTTTTTTTTTTTTTTTTTTTTTTTTTTTTTTTTTTTTTTTTTTTTTTTTTTTTTTTTTTTTTTTTTTTTTTTTTTTTTTTTSTTTTTTTF              m m    
       b       b b       b  m m                 b       b                                                                                   b       b              m m
       b       b b       b  m m                 b       b     yTTTTTTTTTTTTTTTTTTTTTTTTTTTTTTTTTTTTTTTTTTTTTTTTTTTTTTTTTTTTTTTTTTTTTTTx     b       b              m m    
       b       b b       b  m m                 b       b     b                                                                       b     b       b              m m    
       b       b b       b  m m     yTTTTTTTTTTTjTTTTTTTw                                                                                   zTTTTTTTjTTTTTTTTTTx   m m    
       b       b b       b  m m     b              <TTT                                                                                        <TTT            b   m m    
       b       b b       b  m m     b                                                                                                                          b   m m    
       b       b b       b  m m     b    T T T T T T T T T T T T T TT T T T T T T T T T T T T T T T T T T T T T T T T T T T T T T T T T T T T T T T T T T T    b   m m    
       b       b b       b  m m     b   b                                                                                                                  b   b   m m    
       b       b b       b  m m     b              TTT>                                                                                        TTT>            b   m m    
       b       b b       b  m m     b   b   yTTTTTTTTTTTTTTTTTTTTTTTTTTTTTTTTTTTTTTTTTTTTTTTTTTTTTTTTTTTTTTTTTTTTTTTTTTTTTTTTTTTTTTTTTTTTTTTTTTTTTTTTTTx   b   b   m m    
       b       b b       b  m m     b       b                                                                                                          b       b   m m    
       b       b b       b  m m     b   b   b                                                                                                          b   b   b   m m    
       b       b b       b  m m     b       b         yTTTTSTTTTSTTTTSTTTTSTTTTSTTTTSTTTTSTTTx                       yTTTTSTTTTSTTTTSTTTTSTTTx         b       b   m m   
       b       b b       b  m m     b   b   b         b    b    b    b    b    b    b    b   b                       b    b    b    b    b   b         b   b   b   m m    
       b       b b       b  m m     b       zTTTTTTTTTw                                      zTTTTTTTTTTTTTTTTTTTTTTTw                       zTTTTTTTTTw       b   m m    
       b       b b       b  m m     b   b    <TTT                                                                                                <TTT      b   b   m m    
       b       b b       b  m m     b                                                                                                                          b   m m    
       b       b b       b  m m     b   b     T T T T T T T T T T T T T T T T T T T T T T TT T T T T T T T T T T T T T T T T T T T T T T T T T T T T T     b   b   m m    
       b       b b       b  m m     b         T T T T T T T T T T T T T T T T T T T T T  T T T T T T T T T T T T T T T T T T T T T T T T T T T T T T T         b   m m    
       b       b b       b  m m     b   b                                                                                                                  b   b   m m    
       b       b b       b  m m     b        TTT>                                                                                                TTT>          b   m m    
       b       b b       b  m m     b   b   yTTTTTTTTTTx                                     yTTTTTTTTTTTTTTTTTTTTTTTx                       yTTTTTTTTTx   b   b   m m    
       b       b b       b  m m     b       b          b    b    b    b    b   b    b    b   b                       b    b    b    b    b   b         b       b   m m    
       b       b b       b  m m     b   b   b          zTTTTjTTTTjTTTTjTTTTjTTTjTTTTjTTTTjTTTw                       zTTTTjTTTTjTTTTjTTTTjTTTw         b   b   b   m m    
       b       b b       b  m m     b       b                                                                                                          b       b   m m    
       b       b b       b  m m     b   b   b                                                                                                          b   b   b   m m    